10 10
T.....XS..
XX..XXXXX.
X.........
XXXXXXX...
G...X.....
XX..XGXXX.
K...X.X...
XX.XXXX...
..........
XX...XX...